NO textures/BlueGreyDark/Bluegreyeagle.png
SO textures/BlueGreyDark/Bluegreywreath.png
WE textures/BlueGreyDark/BluegreyswasL.png
EA textures/BlueGreyDark/Bluegreywall.png
C 135,206,235
F 128,128,128
11111111111111111111111111111
10000000001100000000000000001
10110111101111111111111110001
10010000000000000000000010001
11110111111111011111111010001
10000000000000000000001000001
10111111111111111111111011101
10000000000000000000000010001
11111111111111111111111010001
10000000000000000000000010001
10000000000000000000000000001
100000000000000000000000N0001
11111111111111111111111111111