NO assets/textures/tech/TECH_4F.PNG
SO assets/textures/tech/TECH_1E.PNG
WE assets/textures/tech/TECH_2F.PNG
EA assets/textures/tech/TECH_3B.PNG
C 135,206,235
F 110,75,55
11111111111111111111111111111
10N00000000000000000000000001
11111111111111111111111111111
