111111
1C0011
100C01
1P0E1
111111