11111111
1E100001
1C1P0001
11111111