11111111
1E0000C1
100P0001
1111111