11111111
1E0001C1
100P0101
11111111