11111111
1E000001
100C0001
11111111