11111111
1C000001
100P0001
11111111