11111111
1E000001
100P0001
11111111