11111111
1E0000C1
100P0 00
11111111