11111111
1E0100C1
101P1001
11111111