1111111111111111
1C00000P000000C1
1011111111111101
1010000000000101
1010111111110101
10101C0000000101
1010101111110101
1010101C00000101
101C101011110101
1010101010000101
1C10101010110101
1010101C10100101
1010101011111101
10101010000000C1
101E111111111111
1111111111111111
