111111111111111111111111111111111111111111111
1P0001000000000
111101011111101
1C0000010000001
101111110111111
1
1
1
1
1
1
1
1
1
1
1
1
1
1
1
1
1
10000000
111111111111111111111111111111111111111111111