1111111
1C0C111
10001C1
1000101
1000101
1000001
101P001
1C1E001
1111001
1111111