11111111111111111111111111111
1PE00000000000000000000000001
1C111111111111111111111111101
10100000000000000000000000101
10101111111111111111111110101
10101000000000000000000000101
10101011111111111111111110101
10101010000000000000000000101
10101010111111111111111110101
10101010100000000000000000101
10101010101111111111111110101
10101010101000000000000000101
10101010101011111111111110101
10101010101010000000000000101
10101010101010111111111110101
11111111111111111111111111111
