11111
1C001
1C001
1C001
1C001
1C001
1C001
1C001
1C001
1C001
1C001
1C001
1C001
1C001
1C001
101P1
1C1E1
11111
11111